1 ./assets/wall.xpm
2 ./assets/wall2.xpm
3 ./assets/wall1.xpm
4 ./assets/flag.xpm
5 ./assets/wall4.xpm
6 ./assets/door.xpm
C ./assets/sky.xpm
F ./assets/floors.xpm
H ./assets/hand.xpm
K ./assets/key.xpm
M ./assets/monster.xpm
        12114115114 3511411511411231245111151521111111111
        30000000001200000000000000000001000000000000000003
        10000000001100000000000000000001000000000000000001
        10110000011100L000000000000000060000000000000000011
        10010000000000000000N000000000010000000000000000001
12111111101100000111000000000000000000010000000000000000011
3000000000110000011101111301113211111112000000000000000001
11110111111111011100000120000003       131111111111111111
1111011141141101110101011M000001
11000000110101011100000010001001
1000K0000000000011000000100M0002
1000000000000000011010100000013
110000014101010141110011100001
31110111 1110101 50001103M00002
12111111 1111111 11141151241131
