1 ./assets/wall.xpm
2 ./assets/wall2.xpm
3 ./assets/wall1.xpm
4 ./assets/flag.xpm
5 ./assets/wall4.xpm
6 ./assets/door.xpm
C ./assets/sky.xpm
F ./assets/floors.xpm
H ./assets/hand.xpm
K ./assets/key.xpm
M ./assets/monster.xpm
131111111111111111141111111111111111111111111111111111121
200000001000000000000000010000000000000000000000100000003
10E000000000000M0000010001000001114111110000M000000000001
100000001000000000000111110000000000005100000000000000001
111411001000000000000100000000M00000111100000000100000001
100001001111114110111100000141111111111111000000100000001
100001000000001000000100000000000010000000000001141101101
10000000M00100100000000000000000000000000M000000000101001
100001000001111000011110000000000010000000000000000101001
10010100000000000M000100001114111111111300000000000101001111111111111111111121
100101111111110000000100001            12111000000010100100000000100000M000003
30010000000000000111110000111121       11000000000141100100000000100000000001
 2111111111000000000010000000003      1000000000001000001000010000001111111111
     100000001110000010001001111     13000001000001001111000010010001
   11100000001 10000000001000001     20000013000000000000000010010111
   10000000001100000000011111111     100011112110000001110000100101
   1000M000000001111110000000005     11000000151000000M0000001111011111111111111111111111
   10000010011111    10000011111     1311111000100001111110000000000000011000000000010001
   11100010000001    4000000001      2000M01000000000000000000000010000000000011000060001
      10010000001    1000010001      1001111000000110000001100111111111111111111111110001
     10000000000011110000010001      1001001000000110000001000000005                11111
    100000110000000100000110001      1000001111000000001111000011111
    100000010000000000001110000111  100M000000100000000000000001
   10001000110000M000001110000000111000000001111111110000111011
11100001000010001L000011100000000001000000000000110000010101001
1000100000001100111101110000M0000000000000000000100000010101001
10001000000000110000000000000000011111111000010010000001110101
11111000001111111111000000000000001000000000010000001000000001
1000M0000011000100000001111100000110000111111101111110101111121
3000000000130000000000015000000001100000000001000M0000100000003
121110000011211111111101111111110110111411111111511111111151111
    10000001         101       101101
    10000111         101       101001
    10010001         101       100001
    11011001         101       100001
    10001001         101       100001
    10001001111    13101       100001111112
   10M001000001    20001       1000000000003
   300001110001    1011        1001111000001
    2100001111     10111111111110000011111112
13111110001        100000000000000000000000003
2000M000001        101111111111111111111100001
10000000001        101              3111100001
10010011111        101111111111111120000000002
3001002           111110000000000001000M00013
121113            3000M000001000000100000002
                  1211111001110000000002113
                         10010011111113
                         3000002
                         121013
                           1K1
                           151