1 ./assets/wall.xpm
2 ./assets/wall2.xpm
3 ./assets/wall1.xpm
6 ./assets/door.xpm
C ./assets/floors.xpm
F ./assets/sky.xpm
H ./assets/hand.xpm
K ./assets/key.xpm
11111111111111111111111111111111111111111111111111111111
10000000000000000000000000000000000000000000000000000001
10000000000000000000000000000000000000000000000000000001
10000000000000000000000000000000000000000000000000000001
1000000000000000000000000000S000000000000000000000000001
10000000000000000000000000000000000000000000000000000001
10000000000000000000000000000000000000000000000000000001
10000000000000000000000000000000000000000000000000000001
10000000000000000000000000000000000000000000000000000001
10000000000000000000000000000000000000000000000000000001
10000000000000000000000000000000000000000000000000000001
10000000000000000000000000000000000000000000000000000001
10000000000000000000000000000000000000000000000000000001
11111111111111111100111111111111111110011111111111111111
                 1001               1001
                 1001               1001
                 1001               1001
                 1001               3002
                100001             200003
                100001             100001
                1000011111111111111100001
                1000000000000000000000001
                1000011111111111111100001
                100001             300002
                 1001               2003
                 1001               1001
                 1001               1001
                 1001               1001
11111111111111111100111111111111111110011111111111111111
10000000000000000000000000000000000000000000000000000001
10000000000000000000000000000000000000000000000000000001
10000000000000000000000000000000000000000000000000000001
10000000000000000000000000000000000000000000000000000001
10000000000000000000000000000000000000000000000000000001
10000000000000000000000000000000000000000000000000000001
10000000000000000000000000000000000000000000000000000001
10000000000000000000000000000000000000000000000000000001
10000000000000000000000000000000000000000000000000000001
10000000000000000000000000000000000000000000000000000001
10000000000000000000000000000000000000000000000000000001
10000000000000000000000000000000000000000000000000000001
11111111111111111111111111111111111111111111111111111111